Entry word	Category	Lexc LHS	Lexc RHS 	uzb
а	CC	а		
а	IJ	а		
а	QST	а		
abad 	A2	abad 		obod
abadan 	A2	adaban		obodon
abadanlastır 	V-TV 	abadanlastır		
abadanlıq	N1 	abadanlıq		
abajur	N1 	abajur		abajur
abazinli	N2	abazinli		abazinlik
abay	N1 	abay 		do‘q
abay et	V-IV	abay et 		do‘q qilmoq;qo‘rqitmoq;tahdid qilmoq;xavf tug‘dirmoq
abayla	V-TV	abayla		
abaylat	V-TV-CAUS	abaylat		
abaylattır	V-TV-CAUS	abaylattır		
abaylaw	V-TV	abayla		
abaylı	A2	abaylı		
abaysız	A1	abaysız		
abaysızda	ADV	abaysızda		
abaysızlıq	N1 	abaysızlıq		
abat	A2	abat		
abatla	V-TV	abatla		
abatlan	V-IV-REFL	abatlan		
abatlandır	V-TV-CAUS	abatlandır		
abatlı	S2	abatlı		
abatlıq	N1 	abatlıq		
abatlılıq	N1 	abatlılıq		
abzal	A1	abzal		
abzalında	ADV	abzalında		
abzac	N1 	abzac		
abissin	N1-NAT	abissin		
abonement	N1 	abonement		
abonent	N1 	abonent		
abort	N1 	abort		
abroy	N1 	abroy		
abroylı	A2	abroylı		
abroysız	A1	abroysız		
abroysızlan	V-IV	abroysızlan		
abroysızlanıw	V-IV	abroysızlan		
abroysızlıq	N1 	abroysızlıq		
absolyut	N1 	absolyut		
absolyut	A2	absolyut		
absolyutizm	N1 	absolyutizm		
absolyutlik	N1 	absolyutlik		
abstrakt	A2	abstrakt		
abstraktla	V-TV	abstraktla		
abstraktlan	V-IV-REFL	abstraktlan		
abstraktlandır	V-TV-CAUS	abstraktlandır		
abstraktlanıw	V-IV-REFL	abstraktlan		
abstrakciya	N1 	abstrakciya		
abstrakciyala	V-TV	abstrakciyala		
abstrakciyalıq	N1 	abstrakciyalıq		
abxaz	N1-NAT	abxaz		
abıroy	N1 	abıroy		
abır-sabır	N1 	abır-sabır		
abısın	N1 	abısın		
abısın-ajın	N1 	abısın-ajın		
avangard	N1 	avangard		
avans	N1 	avans		
avansla	N1 	avansla		
avanslay	V-TV	avanslay		
avanslaw	V-TV	avansla		
avantyura	N1 	avantyura		
avantyuralıq	A2	avantyuralıq		
avantyurizm	N1 	avantyurizm		
avantyurist	N1 	avantyurist		
avantyuristlik	A2	avantyuristlik		
avar	N1-NAT	avar		
avariya	N1 	avariya		
avgust	N1 	avgust		
aviabaza	N1 	aviabaza		
aviabilet	N1 	aviabilet		
aviadesant	N1 	aviadesant		
aviakonstruktor	N1 	aviakonstruktor		
avianosec	N1 	avianosec		
aviapark	N1 	aviapark		
avipochta	N1 	avipochta		
aviator	N1 	aviator		
aviaciya	N1 	aviaciya		
avstraliya	NP-TOP	avstraliya		
avstriyalı	N1-NAT	avstriyalı		
avtobaza	N1 	avtobaza		
avtobiografiya	N1 	avtobiografiya		
avtobiografiyalıq	A2	avtobiografiyalıq		
avtobus	N1 	avtobus		
avtograf	N1 	avtograf		
avtokolonna	N1 	avtokolonna		
avtomat	N1 	avtomat		
avtomatlandır	V-TV	avtomatlandır		
avtomatlandırıw	V-TV	avtomatlandır		
avtomatlastır	V-TV	avtomatlastır		
avtomatlı	A2	avtomatlı		
avtomatsha	ADV	avtomatsha		
avtomatshı	N1 	avtomatshı		
avtomashina	N1	avtomashina		
avtomobil	N1	avtomobil		
avtonomiya	N1	avtonomiya		
avtonomiyalı	A2	avtonomiyalı		
avtor	N1	avtor		
avtoritet	N1	avtoritet		
avtoritetli	A2	avtoritetli		
avtorlıq	N1	avtorlıq		
avtotransport	N1	avtotransport		
agent	N1	agent		
agentlik	N1	agentlik		
agentura	N1	agentura		
agitator	N1	agitator		
agitatorlıq	A2	agitatorlıq		
agitacion	A2	agitacion		
agitaciya	N1	agitaciya		
agitaciyala	V-TV	agitaciyala		
agitpunkt	N1	agitpunkt		
agrar	A2	agrar		
agrarlıq	A2	agrarlıq		
agregat	N1	agregat		
agressiv	A2	agressiv		
agressivlik	N1	agressivlik		
agressiya	N1	agressiya		
agressiyalıq	A2	agressiyalıq		
agressiyashıl	A2	agressiyashıl		
agresiyashıllıq	N1	agresiyashıllıq		
agressor	N1	agressor		
agronom	N1	agronom		
agronomiya	N1	agronomiya		
agronomiyalıq	A2	agronomiyalıq		
agrotexnika	N1	agrotexnika		
aǵa	N1	aǵa		
aǵajan	N1	aǵajan		
aǵajanla	V-TV	aǵajanla		
aǵa-ini	N1	aǵa-ini		
aǵayın	N1	aǵayın		
aǵayınlı	A2	aǵayınlı		
aǵayınlıq	N1	aǵayınlıq		
aǵayın-tuwǵan	N1	aǵayın-tuwǵan		
aǵayınshıl	A2	aǵayınshıl		
aǵayınshıllıq	N1	aǵayınshıllıq		
aǵalıq	N1	aǵalıq		
aǵar	V-IV	aǵar		
aǵarańla	V-IV	aǵarańla		
aǵarǵan	N1	aǵarǵan		
aǵart	V-TV-CAUS	aǵart		
aǵarttır	V-TV-CAUS	aǵarttır		
aǵartıl	V-TV-CAUS	aǵart		
aǵartıw	V-TV-CAUS	aǵart		
aǵartıwshı	N1	aǵartıwshı		
aǵartıwshı	N1	aǵartıwshı		
aǵarı	N1	aǵarı		
aǵarıw	V-IV	aǵar		
aǵaw	N1	aǵaw		
aǵash	N1	aǵash		
aǵashlı	A2	aǵashlı		
aǵashlıq	N1	aǵashlıq		
aǵash-paǵash	N1	aǵash-paǵash		
aǵashshı	N1	aǵashshı		
aǵza	N1	aǵza		
aǵzalan	V-IV	aǵzalan		
aǵzalanıw	V-IV	aǵzalan		
aǵzalat	V-TV	aǵzalat		
aǵzalıq	A2	aǵzalıq		
aǵız	V-TV-CAUS	aǵız		
aǵızdır	V-TV-CAUS	aǵızdır		
aǵızıl	V-TV-CAUS	aǵız		
aǵızıs	V-TV-COOP	aǵızıs		
aǵızıw	V-TV-CAUS	aǵız		
aǵıl	V-IV	aǵıl		
aǵıl-tegil	ADV	aǵıl-tegil		
aǵılıw	V-IV	aǵıl		
aǵım	N1	aǵım		
aǵımdaǵı	A2	aǵımdaǵı		
aǵın	A2	aǵın		
aǵıraq	A2	aq		
aǵıs	N1	aǵıs		
aǵıslı	A2	aǵıslı		
aǵıt	V-TV	aǵıt		
aǵıtıw	V-TV	aǵıt		
aǵıw	V-IV	aq		
ada	N1	ada		
ada bol	V-IV	ada bol		
ada et	V-TV	ada et		
adaq	N1	adaq		
adaqla	V-TV	adaqla		
adala	V-TV	adala		
adalat	N1	adalat		
adalatlı	A2	adalatlı		
adalatlıq	N1	adalatlıq		
adalatsız	A1	adalatsız		
adalaw	V-TV	adala		
adam	N1	adam		
adamgershilik	N1	adamgershilik		
adamgershilikli	A2	adamgershilikli		
adamgershiliksiz	A1	adamgershiliksiz		
adamgershiliksizlik	N1	adamgershiliksizlik		
adamzat	N1	adamzat		
adam-padam	N1	adam-padam		
adamsın	V-TV	adamsın		
adamsınt	V-TV-CAUS	adamsınt		
adamsıntıw	V-TV-CAUS	adamsınt		
adamshılıq	N1	adamshılıq		
adas	V-IV	adas		
adas	N1	adas		
adasqaq	A2	adasqaq		
adastır	V-TV-CAUS	adastır		
adastırıl	V-TV-CAUS	adastırıl		
adastırıw	V-TV-CAUS	adastır		
adasıw	V-IV	adas		
adasıwshılıq	N1	adasıwshılıq		
adawat	N1	adawat		
adawatlas	V-IV	adawatlas		
adawatlı	A2	adawatlı		
advokat	N1	advokat		
advokatlıq	N1	advokatlıq		
adjar	N1-NAT	adjar		
administrator	N1	administrator		
administraciya	N1	administraciya		
admiral	N1	admiral		
adraspan	N1	adraspan		
adres	N1	adres		
adresat	N1	adresat		
adyutant	N1	adyutant		
adıgey	N1-NAT	adıgey		
adım	N1	adım		
adımla	V-IV	adımla		
adımlat	V-TV-CAUS	adımlat		
adımlaw	V-IV	adımla		
adımlawshı	V-IV	adımla		
adımsız	A1	adımsız		
adır	N1	adır		
adır	A2	adır		
adıray	V-IV	adıray		
adırayt	V-TV-CAUS	adırayt		
adıraytıw	V-TV-CAUS	adırayt		
adırayıw	V-IV	adıray		
adıraq	A2	adıraq		
adırańla	V-IV	adırańla		
adırańlat	V-TV-CAUS	adırańlat		
adırańlaw	V-IV	adırańla		
adır-budır	A2	adır-budır		
adırlan	V-IV	adırlan		
adırlı	A2	adırlı		
adırsımaq	A2	adırsımaq		
ajayıp	A1	ajayıp		
ajayıplan	V-IV	ajayıplan		
ajayıplanıw	V-IV	ajayıplan		
ajayıpxana	N1	ajayıpxana		
ajar	N1	ajar		
ajarlan	V-IV	ajarlan		
ajarlandır	V-TV-CAUS	ajarlandır		
ajarlant	V-TV-CAUS	ajarlant		
ajarlanıw	V-IV	ajarlan		
ajarlı	A2	ajarlı		
ajarsız	A1	ajarsız		
ajarsızlan	V-IV	ajarsızlan		
ajarsızlanıw	V-IV	ajarsızlan		
ajdarha	N1	ajdarha		
ajıral	V-IV	ajıral		
ajıralıs	V-IV-COOP	ajıral		
ajıralıw	V-IV	ajıral		
ajıralıwshılıq	N1	ajıralıwshılıq		
ajıras	V-IV	ajıras		
ajıraspas	A2	ajıraspas		
ajırasıw	V-IV	ajıras		
ajırat	V-TV	ajırat		
ajırattır	V-TV-CAUS	ajırattır		
ajıragıs	V-IV-COOP	ajıragıs		
ajıratıw	V-TV	ajırat		
ajırıq	N1	ajırıq		
az	ADV	az		
az	V-IV	az		
az	V-IV	az		
aza	N1	aza		
aza boyı tik tur	V-IV	aza boyı tik tur		
azada	A2	azada		
azadala	V-TV	azadala		
azadalıq	N1	azadalıq		
azadar	A2	azadar		
azay	V-IV	azay		
azayt	V-TV	azayt		
azaytqısh	N1	azaytqısh		
azayttır	V-TV-CAUS	azayttır		
azaytıl	V-TV	azayt		
azaytıw	V-TV	azayt		
azayıw	V-IV	azay		
azala	V-IV	azala		
azalaw	V-IV	azala		
azalı	A2	azalı		
azamat	N1	azamat		
azamatlıq	N1	azamatlıq		
azamatshılıq	N1	azamatshılıq		
azan	N1	azan		
azan-gazan	N1	azan-gazan		
azanǵı	A2	azanǵı		
azanda	ADV	azanda		
azanshı	N1	azanshı		
azap	N1	azap		
azap-dozaq	N1	azap-dozaq		
azapla	V-TV	azapla		
azaplan	V-IV-REFL	azaplan		
azaplandır	V-TV-CAUS	azaplandır		
azaplanıw	V-IV-RELF	azaplan		
azaplat	V-TV-CAUS	azaplat		
azaplaw	V-TV	azapla		
azaplı	A2	azaplı		
azar	N1	azar		
azar	ADV	azar		
azar-bezer	A2	azar-bezer		
azarlan	V-IV	azarlan		
azarlandır	V-TV-CAUS	azarlandır		
azarlanıw	V-IV	azarlan		
azarlı	A2	azarlı		
azat	A1	azat		
azatlıq	N1	azatlıq		
azatshılıq	N1	azatshılıq		
azǵan-tozǵan	A2	Azǵan-tozǵan		
azǵantay	ADV	azǵantay		
azǵın	N1	azǵın		
azǵın	A2	azǵın		
azǵır	V-TV-CAUS	azǵır		
azǵırıl	V-TV-CAUS	azǵır		
azǵırıw	V-TV-CAUS	azǵır		
azǵırıwshı	N1	azǵırıwshi		
azǵırıwshılıq	N1	azǵırıwshılıq		
azdır	V-TV-CAUS	azdır		
azdır	V-TV-CAUS	azdır		
azdırt	V-TV-CAUS	azdırt		
azdırt	V-TV-CAUS	azdırt		
azdırıl	V-TV-CAUS	azdır		
azdırıl	V-TV-CAUS	azdır		
azdırıw	V-TV-CAUS	azdır		
azlap	ADV	azlap		
azlıq	N1	azlıq		
az-maz	ADV	Az-maz		
azna	N1	azna		
aznawlaq	A1	aznawlaq		
azot	N1	azot		
azotlı	A2	azotlı		
azsın	V-IV	azsın		
azsınıw	V-IV	azsın		
azuw	N1	azuw		
azuwlı	A2	azuwlı		
azshılıq	N1	azshılıq		
azı-kem	ADV	azı-kem		
azıq	N1	azıq		
azıq-awqat	N1	azıq-awqat		
azıqlan	N1	azıqlan		
azıqlandır	V-IV	azıqlandır		
azıqlı	V-TV-CAUS	azıqlı		
azıksız	A1	azıksız		
azıqsızlıq	N1	azıqsızlıq		
azıq-awqat	N1	azıq-awqat		
azıq-túlik	N1	azıq-túlik		
azımshıq	ADV	azımshıq		
azına	V-IV	azına		
azınas	V-IV-COOP	azınas		
azınat	V-TV-CAUS	azınat		
azıńqı	A2	azıńqı		
azıw	V-IV	az		
ay	N1	ay		
ay	IJ	ay		
aybaraq	N1	aybaraq		
aybat	N1	aybat		
aybatlan	V-IV	aybatlan		
aybatlanıw	V-IV	aybatlan		
aybatlı	A2	aybatlı		
aybatlılıq	N1	aybatlılıq		
aybın	V-IV	aybın		
aybındır	V-TV-CAUS	aybındır		
aybınıw	V-IV	aybın		
ayǵabaǵar	N1	ayǵabaǵar		
ayǵaq	N1	ayǵaq		
ayǵaqlıq	N1	ayǵaqlıq		
ayǵır	N1	ayǵır		
ayǵırsha	N1	ayǵırsha		
ayda	V-TV	ayda		
aydal	V-TV	ayda		
aydalın	V-IV-REFL	aydalın		
aydalıw	V-TV	ayda		
aydalıwshı	V-TV	ayda		
aydan-anıq	A1	aydan-anıq		
aydar	N1	aydar		
aydarlan	V-IV	aydarlan		
aydarlandır	V-TV-CAUS	aydarlandır		
aydarlı	A2	aydarlı		
aydarsız	A1	aydarsız		
aydarha	N1	aydarha		
aydas	V-TV-COOP	aydas		
aydat	V-TV-CAUS	aydat		
aydatıw	V-TV-COOP	aydat		
aydaw	V-TV	ayda		
aydawlı	A2	aydawlı		
aydawshı	N1	aydawshı		
aydıllı	A2	aydıllı		
aydın	N1	aydın		
aydınla	V-IV	aydınla		
aydınlat	V-TV	aydınlat		
aydınlı	A2	aydınlı		
ayqay	N1	ayqay		
ayqay sal	V-IV	ayqay sal		
ayqayla	V-IV	ayqayla		
ayqaylaw	V-IV	ayqayla		
ayqas	V-IV	ayqas		
ayqaspa	N1	ayqaspa		
ayqastır	V-TV-CAUS	ayqastır		
ayqasıw	V-IV	ayqas		
ayqın	A1	ayqın		
ayqınla	V-TV	ayqınla		
ayqınlan	V-TV	ayqınla		
ayqınlawısh	A2	ayqınlawısh		
ayqır	V-TV	ayqır		
ayqısh-uyqısh	ADV	ayqısh-uyqısh		
aylan	V-IV	aylan		
aylana	N1	aylana		
aylanada	N1	aylana		
aylanayın	N1	aylanayın		
aylanba	N1	aylanba		
aylanbalı	A2	aylanbalı		
aylandır	V-TV-CAUS	aylandır		
aylandırıw	V-TV-CAUS	aylandır		
aylanıs	V-IV-COOP	aylanıs		
aylanıw	V-IV	aylan		
aylanısh	A2	aylanısh		
aylanısh	N1	aylanısh		
aylanıshlıq	N1	aylanıshlıq		
aylas	N1	aylas		
aylı	A2	aylı		
aylıq	A2	aylıq		
aylıq	N1	aylıq		
aylıqlı	A2	aylıqlı		
aymaq	N1	aymaq		
aymala	V-TV	aymala		
aymalaw	V-TV	aymala		
aymanday	A2	aymanday		
ayna	N1	ayna		
aynal	V-IV	aynal		
aynala	N1	aynala		
aynalayın	N1	aynalayın		
aynalǵısh	A2	aynalǵısh		
alynalma	N1	alynalma		
aynalshaq	A2	aynalshaq		
aynalıs	N1	aynalıs		
aynalıs	V-IV	aynalıs		
aynalısıw	V-IV	aynalıs		
aynanayın	N1	aynanayın		
aynı	V-IV	aynı		
aynıǵan	A2	aynıǵan		
aynıǵanlıq	N1	aynıǵanlıq		
aynıǵısh	A2	aynıǵısh		
aynıǵıshlıq	N1	aynıǵıshlıq		
aynıma	A2	aynıma		
aynımalı	A2	aynımalı		
aynıttır	V-TV-CAUS	aynıttır		
aynıtıw	V-TV-CAUS	aynıt		
aynıw	V-IV	aynı		
aypap-jaypa	V-TV	aypap-jaypa		
ayran	N1	ayran		
ayrı	N1	ayrı		
ayrıq	A2	ayrıq		
ayrıqsha	N1	ayrıqsha		
ayrıqshalıq	N1	ayrıqshalıq		
ayrıl	V-IV	ayrıl		
ayrılıs	V-IV-COOP	ayrılıs		
ayrıplan	N1	ayrıplan		
ayrıs	V-TV-COOP	ayır		
ayrıw	V-TV	ayır		
aysız	A1	aysız		
ayt	N1	ayt		
ayt	V-TV	ayt		
aytarlıq	V-TV	ayt		
aytarlıqtay	V-TV	ayt		
aytqız	V-TV-CAUS	aytqız		
aytqısh	N1	aytqısh		
aytla	V-TV	aytla		
aytlat	V-TV-CAUS	aytlat		
aytlıq	N1	aytlıq		
aytpaqshı	PAREN	aytpaqshı		
ayttır	V-TV-CAUS	ayttır		
ayttırıw	V-TV-CAUS	ayttır		
aytıl	V-TV	ayt		
aytılıs	N1	aytılıs		
aytılıw	V-TV	ayt		
aytıs	N1	aytıs		
aytıs	V-IV-COOP	aytıs		
aytıstır	V-TV-CAUS	aytıstır		
aytısıw	V-IV-COOP	aytıs		
aytıw	V-TV	ayt		
aytıwlı	A2	aytıwlı		
aytıwsız	A1	aytıwsız		
aytıwshı	V-TV	ayt		
aywan	N1	aywan		
ayshıq	N1	ayshıq		
ayshılıq	A2	ayshılıq		
ayıǵıw	V-IV	ayıǵ		
ayıq	A2	ayıq		
ayıq	V-IV	ayıq		
ayıqtır	V-TV-CAUS	ayıqtır		
ayıqtırıw	V-TV-CAUS	ayıqtır		
ayıl	N1	ayıl		
ayın	A2	ayın		
ayıp	N1	ayıp		
ayıpdar	N1	ayıpdar		
ayıpker	N1	ayıpker		
ayıpkerlik	N1	ayıpkerlik		
ayıpkersizlik	N1	ayıpkersizlik		
ayıpla	V-TV	ayıpla		
ayıplan	V-TV	ayıpla		
ayıplanıw	V-TV	ayıpla		
ayıplanıwshı	N1	ayıplanıwshı		
ayıplaw	V-TV	ayıpla		
ayıplı	A2	ayıplı		
ayıplılıq	N1	ayıplılıq		
ayıpsız	A1	ayıpsız		
ayıpsızlıq	N1	ayıpsızlıq		
ayır	A2	ayır		
ayır	V-TV	ayır		
ayırbas	N1	ayırbas		
ayırbasla	V-TV	ayırbasla		
ayırbaslaw	V-TV	ayırbasla		
ayırǵısh	A2	ayırǵısh		
ayırma	N1	ayırma		
ayırt	V-TV-CAUS	ayırt		
ayırtıw	V-TV-CAUS	ayırt		
ayırıq	N1	ayırıq		
ayırıl	V-IV-REFL	ayırıl		
ayırılmas	A2	ayırılmas		
ayırılıs	V-IV-COOP	ayırılıs		
ayırılıstır	V-TV-CAUS	ayırılıstır		
ayırılısıw	V-IV-COOP	ayırılıs		
ayırılıw	V-IV-REFL	ayırıl		
ayırım	A1	ayırım		
ayırımlıq	N1	ayırımlıq		
ayırıs	V-IV-COOP	ayırıs		
ayırısıw	V-IV-COOP	ayırıs		
ayırıw	V-TV	ayır		
akademik	N1	akademik		
akademiyalıq	A2	akademiyalıq		
akaciya	N1	akaciya		
akvarel	N1	akvarel		
akvarium	N1	akvarium		
akkompanement	N1	akkompanement		
akkompanementle	V-IV	akkompanementle		
akkompanementlewshi	N1	akkompanementlewshi		
akkordeon	N1	akkordeon		
akkreditiv	N1	akkreditiv		
akkumulyator	N1	akkumulyator		
akrobat	N1	akrobat		
akrobatlıq	A2	akrobatlıq		
aksioma	N1	aksioma		
akg	N1	akg		
aktyor	N1	aktyor		
aktiv	A1	aktiv		
aktiv	N1	aktiv		
aktivle	V-TV	aktivle		
aktivlen	V-IV-REFL	aktivlen		
aktivlengen	V-IV-REFL	aktivlen		
aktivles	V-IV	aktivles		
aktivlesiw	V-IV	aktivles		
aktivlestir	V-TV-CAUS	aktivlestir		
aktmvlestiril	V-TV-CAUS	aktmvlestir		
aktivlestiriw	V-TV-CAUS	aktivlestir		
aktivli	A2	aktivli		
aktivlik	N1	aktivlik		
aktle	V-TV	aktle		
aktlen	V-TV	aktle		
aktlew	V-TV	aktle		
aktrisa	N1	aktrisa		
aktual	A2	aktual		
akustika	N1	akustika		
akustikalıq	A2	akustikalıq		
akusherka	N1	akusherka		
akusherkalıq	N1	akusherkalıq		
akusherkalıq	A2	akusherkalıq		
akcionerlik	A2	akcionerlik		
akciya	N1	akciya		
aq	A2	aq		
aq	V-IV	aq		
aqaw	N1	aqaw		
aqbas	N1	aqbas		
aqbilek	N1	aqbilek		
aqqısh	A2	aqqısh		
aqquw	N1	aqquw		
aqla	V-TV	aqla		
aqlan	V-IV-REFL	aqlan		
aqlanıw	V-IV-REFL	aqlan		
aqlat	V-TV-CAUS	aqlat		
aqlattır	V-TV-CAUS	aqlattır		
aqlatıw	V-TV-CAUS	aqlat		
aqlaw	V-TV	aqla		
aqlawshı	N1	aqlawshı		
aqlı	A2	aqlı		
aqlıq	N1	aqlıq		
aqlıq	N1	aqlıq		
aqmaq	A2	aqmaq		
aqmaqlan	V-IV	aqmaqlan		
aqmaqlıq	N1	aqmaqlıq		
aqmaqshılıq	N1	aqmaqshılıq		
aqpa	A2	aqpa		
aqpalıq	N1	aqpalıq		
aqpashılıq	N1	aqpashılıq		
aqrap	N1	aqrap		
aqsa	V-IV	aqsa		
aqsaq	A2	aqsaq		
aqsaqal	N1	aqsaqal		
aqsaqlıq	N1	aqsaqlıq		
aqsańla	V-IV	aqsańla		
aqsańlat	V-TV-CAUS	aqsańlat		
aqsańlaw	V-IV	aqsań		
aqsar	N1	aqsar		
aq-sarǵılt	A2	aq-sarǵılt		
aq-sarı	A2	aq-sarı		
aqsat	V-TV-CAUS	aqsat		
aqsatıw	V-TV-CAUS	aqsat		
aqsaw	V-IV	aqsa		
aqtar	V-TV	aqtar		
aqtarıl	V-TV	aqtar		
aqtarılıw	V-TV	aqtar		
aqtarıw	V-TV	aqtar		
aqun	N1	aqun		
aqwal	N1	aqwal		
aqsha	N1	aqsha		
aqsha	A2	aqsha		
aqshalay	ADV	aqshalay		
aqshalata	ADV	aqshalata		
aqshalı	A2	aqshalı		
aqsham	N1	aqsham		
aqshamlıqta	ADV	aqshamlıqta		
aqshasız	A1	aqshasız		
aqshasızlıq	N1	aqshasızlıq		
aqshıy	V-IV	aqshıy		
aqshıyt	V-TV-CAUS	aqshıyt		
aqshıytıw	V-TV-CAUS	aqshıyt		
aqshıyıw	V-IV	aqshıy		
aqshıl	A2	aqshıl		
aqshıllaw	A2	aqshıllaw		
aqıbet	N1	aqıbet		
aqıy	V-IV	aqıy		
aqıyt	V-TV-CAUS	aqıyt		
aqıytıw	V-TV-CAUS	aqıyt		
aqıyıw	V-IV	aqıy		
aqıq	N1	aqıq		
aqıl	N1	aqıl		
aqılgóy	A2	aqılgóy		
aqılgóyli	A2	aqılgóyli		
aqıllas	N1	aqıllas		
aqıllas	V-IV-COOP	aqıllas		
aqıllasıw	V-IV-COOP	aqıllas		
aqıllılıq	N1	aqıllılıq		
aqılsız	A1	aqılsız		
aqılsızlıq	N1	aqılsızlıq		
aqılsın	V-IV	aqılsın		
aqılshı	N1	aqılshı		
aqır	N1	aqır		
aqır	N1	aqır		
aqır	V-IV	aqır		
aqıra	N1	aqıra		
aqıray	V-IV	aqıray		
aqırayt	V-TV-CAUS	aqırayt		
aqırayıw	V-IV	aqıray		
aqırańla	V-IV	aqırańla		
aqırańlat	V-TV-CAUS	aqırańlat		
aqırǵı	A2	aqırǵı		
aqıret	N1	aqıret		
aqırı	ADV	aqırı		
aqırı'-ayaǵı	ADV	aqırı'-ayaǵı		
aqırı-ayaǵında	ADV	aqırı-ayaǵında		
aqırın	A1	aqırın		
aqırınla	V-IV	aqırınla		
aqırınlap	ADV	aqırınlap		
aqırınlat	V-TV-CAUS	aqırınlat		
aqırınlatıw	V-TV-CAUS	aqırınlat		
aqırınlaw	V-IV	aqırınlaw		
aqırınlıq	N1	aqırınlıq		
aqırıw	V-IV	aqır		
al	CC	al		
al	V-TV	al		
al	VAUX	al		
ala	A2	ala		
alabajaq	A2	alabajaq		
alabota	N1	alabota		
alabuǵa	N1	alabuǵa		
alagswgim	N1	alagswgim		
alaǵada	A2	alaǵada		
alaǵadala	V-TV	alaǵadala		
alaǵadalan	V-IV-REFL	 alaǵadalan		
alaǵadalaw	V-TV	 alaǵadala		
alaǵadalıq	N1	 alaǵadalıq		
alaǵan	a2	 alaǵan		
alaǵat	a2	 alaǵat		
alaǵatlıq	N1	 alaǵatlıq		
ala-ǵula	a2	 ala-ǵula		
ala-ǵulalıq	N1	 ala-ǵulalıq		
alajawlı	A2	 alajawlı		
alaq	A2	 alaq		
alaqay	IJ	 alaqay		
alaqayla	V-IV	 alaqayla		
alaqaylaw	V-IV	 alaqayla		
alaqan	N1	 alaqan		
alaqanday	A2	 alaqanday		
alaqanla	V-TV	 alaqanla		
alaqanlas	V-TV-COOP	 alaqanlas		
alaqanlat	V-TV-CAUS	 alaqanlat		
alaqanlaw	V-TV	 alaqanla		
alaq-julaq	ADV	 alaq-julaq		
alaqla	V-IV	 alaqla		
alaqlaw	V-IV	 alaqla		
alaqshın	N1	 alaqshın		
alala	V-TV	 alala		
alalat	V-TV-CAUS	 alalat		
alalaw	V-TV	 alala		
alalıq	N1	 alalıq		
alaman	N1	 alaman		
alamanla	V-IV	 alamanla		
alamanlat	V-TV-CAUS	 alamanlat		
alamanlatıw	V-TV-CAUS	 alamanlat		
alamanlaw	V-IV	 alamanla		
alamanshılıq	N1	 alamanshılıq		
alamat	N1	 alamat		
alań	N1	 alań		
alań	A2	 alań		
alań bol	V-IV	 alań bol		
alań et	V-TV	 alań et		
alańǵasar	a2	 alańǵasar		
alańǵasarlıq	N1	 alańǵasarlıq		
alańla	V-iv	 alańla		
alańlas	V-TV-COOP	 alańlas		
alańlat	V-TV-CAUS	 alańlat		
alańlatıw	V-TV-CAUS	 alańlat		
alańlaw	V-iv	 alańla		
alap	N1	 alap		
alar-pasırlı	N1	 alar-pasırlı		
alar	V-tv	 alar		
alarman	N1	 alarman		
alart	V-tv-caus	 alart		
alartıw	V-tv-caus	 alart		
alarıw	V-tv	 alar		
alasa	a2	 alasa		
ala-sala	adv	 ala-sala		
ala-sapran	N1	 ala-sapran		
ala-sapırlı	a2	 ala-sapırlı		
alas-qapas	N1	 alas-qapas		
alasla	V-tv	 alasla		
alaslan	V-IV-REFL	 alaslan		
alaslat	V-TV-CAUS	 alaslat		
alaslaw	V-TV	 alasla		
alası	N1	 alası		
alasılı	N1	 alasılı		
alaw	n1	 alaw		
alaw	a2	alaw		
alasha	n1	alasha		
alban	N1-NAT	 alban		
albaslı	N1	 albaslı		
albıra	V-iv	 albıra		
albıras	V-IV-COOP	 albıras		
albırat	V-TV-CAUS	 albırat		
albıratıw	V-TV-CAUS	 albırat		
albıraw	V-iv	 albıra		
algebra	N1	 algebra		
algebralıq	a2	 algebralıq		
alǵa	adv	 alǵa		
alǵarez	adv	 alǵarez		
alǵı-bergi	N1	 alǵı-bergi		
alǵır	a2	 alǵır		
alǵıs	N1	 alǵıs		
alǵısh	a2	 alǵısh		
alda	V-tv	 alda		
aldaǵı	N1	ald		
aldaǵısh	N1	 aldaǵısh		
aldan	V-iv-refl	 aldan		
aldant	V-TV-CAUS	 aldant		
aldanısh	N1	 aldanısh		
aldap-arba	V-tv	 aldap-arba		
aldas	V-IV-COOP	 aldas		
aldastır	V-TV-rep	 aldastır		
aldasıw	V-iv	 aldas		
aldat	V-TV-CAUS	 aldat		
aldatıw	V-TV-CAUS	 aldat		
aldaw	V-tv	 alda		
aldawshı	N1	 aldawshı		
aldawshılıq	N1	 aldawshılıq		
aldawısh	N1	 aldawısh		
aldı	N1	 ald		
aldında	N1	 ald		
aldıńǵı	a2	 aldıńǵı		
aldır	V-TV-CAUS	 aldır		
aldırt	V-TV-CAUS	 aldırt		
aldırtıw	V-TV-CAUS	 aldırt		
aldırıl	V-TV-CAUS	 aldır		
aldırıs	V-TV-CAUS	 aldırıs		
aldırıw	V-TV-CAUS	 aldır		
aleykim-u-salam	ij	 aleykim-u-salam		
aljas	V-iv	 aljas		
aljastır	V-TV-CAUS	 aljastır		
aljastırıw	V-TV-CAUS	 aljastır		
aljasıq	N1	 aljasıq		
aljasıw	V-iv	 aljas		
aljir	N1-NAT	 aljir		
aljı	V-iv	 aljı		
aljıǵır	ij	 aljıǵır		
aljıt	V-TV-CAUS	 aljıt		
aljıtıw	V-TV-CAUS	 aljıt		
aljıw	V-iv	 aljı		
aliment	N1	 aliment		
alkogol	N1	 alkogol		
alqım	N1	 alqım		
alqım	N1	 alqım		
alqın	V-iv	 alqın		
alqındı	N1	 alqındı		
alqınt	V-TV-CAUS	 alqınt		
alqıssa	N1	 alqıssa		
alla	N1	 alla		
alma	N1	 alma		
almalı	a2	 almalı		
almas	N1	 almas		
almas	N1	 almas		
almas	V-tv	 almas		
almasla	V-tv	 almasla		
almaslan	V-IV-REFL	 almaslan		
almastır	V-TV-CAUS	 almastır		
almastırıw	V-TV-CAUS	 almastır		
almasıq	N1	 almasıq		
almasıl	V-tv	 almas		
almasılıw	V-tv	 almasıl		
almasın	V-if-refl	 almasın		
almasıw	V-tv	 almas		
almurt	N1	 almurt		
alp	N1	 alp		
alpıs	num	 alpıs		
alpısınshı	num	 alpıs		
Al-sal bol	V-iv	 Al-sal bol		
altaqta	N1	 altaqta		
altaw	Num-coll	 altaw		
altı	num	 altı		
altıatar	N1	 altıatar		
altılıq	N1	 altılıq		
altın	N1	 altın		
altınla	V-tv	 altınla		
altınlat	V-TV-CAUS	 altınlat		
altınlattır	V-TV-CAUS	 altınlattır		
altınlaw	V-TV	 altınla		
altınlı	a2	 altınlı		
altınshı	num	 altı		
alfavit	N1	 alfavit		
alfavitlik	a2	 alfavitlik		
alshay	V-iv	 alshay		
alshayt	V-TV-CAUS	 alshayt		
alshaytıw	V-TV-CAUS	 alshayt		
alshayıs	V-IV-COOP	 alshayıs		
alshayıw	V-iv	 alshay		
alshaq	a2	 alshaq		
alshaqla	V-TV	 alshaqla		
alshaqlat	V-TV-CAUS	 alshaqlat		
alshaqlıq	N1	 alshaqlıq		
alshańla	V-iv	 alshańla		
alshańlat	V-TV-CAUS	 alshańlat		
alshańlaw	V-iv	 alshańla		
alshı	N1	 alshı		
alshıla	V-iv	 alshıla		
alım	N1	 alım		
alım	a2	 alım		
alım-berim	n1	 alım-berim		
alımlıq	N1	 alımlıq		
alımsaq	N1	 alımsaq		
alım-salıq	N1	 alım-salıq		
alım-salım	N1	 alım-salım		
alın	V-if-refl	 alın		
alınıw	V-if-refl	 alın		
alıńqıra	V-tv	 alıńqıra		
alıp-satar	N1	 alıp-satar		
alıp-satarlık	N1	 alıp-satarlık		
alıs	N1	alıs		
alıs	a1	alıs		
alıs	n1-vn	 alıs		
alıs	V-tv-coop	 alıs		
alıs	V-iv	alıs		
alıs-beris	N1	 alıs-beris		
alısla	V-iv	 alısla		
alıslat	V-TV-CAUS	 alıslat		
alıslatıw	V-TV-CAUS	 alıslat		
alıslıq	N1	 alıslıq		
alısta	N1	 alıs		
alıstaǵı	N1	 alısta		
alıstır	V-TV-CAUS	 alıstır		
alıstır	V-TV-CAUS	 alıstır		
alısıw	V-tv	 alıs		
alısıw	V-iv	 alıs		
alıw	V-tv	 al		
alıwshı	N1	 alıwshı		
alıwshılıq	N1	 alıwshılıq		
albom	N1	 albom		
almanax	N1	 almanax		
alpinizm	N1	 alpinizm		
alpinist	N1	 alpinist		
alpinistlik	a2	 alpinistlik		
alyuminiy	N1	 alyuminiy		
amal	N1	 amal		
aman	a1	 aman		
amanat	N1	 amanat		
amanatsha	N1	 amanatsha		
amanatshı	N1	 amanatshı		
amanlas	V-iv	 amanlas		
amanlastır	V-TV-CAUS	 amanlastır		
amanlastırıw	V-TV-CAUS	 amanlastır		
amanlasıw	V-iv	 amanlas		
amanlıq	N1	 amanlıq		
amanshılıq	N1	 amanshılıq		
ambulatoriya	N1	 ambulatoriya		
amerikan	N1-NAT	 amerikan		
amnistiya	N1	 amnistiya		
amnistiyala	V-tv	 amnistiyala		
amnistiyalaw	V-tv	 amnistiyala		
amortizaciya	N1	 amortizaciya		
amfiteatr	N1	 amfiteatr		
ana	N1	 ana		
ana	Det-dem	 ana		
anaǵurlım	adv	 anaǵurlım		
anaday	Pron-dem	 ana		
analas	a2	 analas		
analiz	N1	 analiz		
analizle	V-tv	 analizle		
analizlew	V-tv	 analizle		
analitik	N1	 analitik		
analitikalıq	a2	 analitikalıq		
analıq	N1	 analıq		
ana-mına	phrase	 ana-mına		
anar	N1	 anar		
anarxizm	N1	 anarxizm		
anarxist	N1	 anarxist		
anarxiya	N1	 anarxiya		
anarxiyalıq	a2	 anarxiyalıq		
anatomiya	N1	 anatomiya		
anaw	Det-dem	 anaw		
anglichan	N1	 anglichan		
anda	Pron-dem	ol		
andaǵı	Pron-dem	ol		
anda-sanda	adv	 anda-sanda		
andız	a2	 andız		
anketa	N1	 anketa		
anketalıq	a2	 anketalıq		
anneksiya	N1	 anneksiya		
annotaciya	N1	 annotaciya		
anons	N1	 anons		
ansambl	N1	 ansambl		
ant	N1	 ant		
antagonizm	N1	 antagonizm		
aptagonistlik	a2	 aptagonistlik		
antala	V-iv	 antala		
antalas	V-IV-COOP	 antalas		
antalat	V-TV-CAUS	 antalat		
antalaw	V-iv	 antala		
antenna	N1	 antenna		
antlas	V-iv	 antlas		
antlastır	V-TV-CAUS	 antlastır		
antlasıw	V-iv	 antlas		
antlı	a2	 antlı		
antologiya	N1	 antologiya		
antrakt	N1	 antrakt		
antxor	N1	 antxor		
ansha	Pron-dem	ol		
anshalıq	Pron-dem	ol		
anshlag	N1	 anshlag		
anıq	a1	 anıq		
anıqla	V-tv	 anıqla		
anıqlama	n1	 anıqlama		
anıqlan	V-tv	 anıqla		
anıklas	V-TV-COOP	 anıklas		
anıqlastır	V-TV-CAUS	 anıqlastır		
anıqlat	V-TV-CAUS	 anıqlat		
anıqlatıw	V-TV-CAUS	 anıqlat		
anıqlaw	V-TV	 anıqla		
anıqlawısh	N1	 anıqlawısh		
ań	N1	 ań		
ań	N1	 ań		
ań	N1	 ań		
ańǵar	N1	 ańǵar		
ańǵar	V-tv	 ańǵar		
anǵarıw	V-tv	 anǵar		
ańqay	V-iv	 ańqay		
ańqayt	V-TV-CAUS	 ańqayt		
ańkaytıw	V-TV-CAUS	 ańkayt		
ańkaw	n1	 ańkaw		
ańqawlan	V-iv	 ańqawlan		
ańqawlanıw	V-iv	 ańqawlan		
ańqawsı	V-iv	 ańqawsı		
ańqawsıra	V-iv	 ańqawsıra		
ańqawsıraw	V-iv	 ańqawsıra		
ańqawsıw	V-iv	 ańqawsı		
ańqawshılıq	N1	 ańqawshılıq		
ańqı	V-iv	 ańqı		
ańqılda	V-iv	 ańqılda		
ańqıldaq	a2	 ańqıldaq		
ańqır	V-iv	 ańqır		
ańqırt	V-TV-CAUS	 ańqırt		
ańqırıw	V-iv	 ańqır		
ańqıt	V-TV-CAUS	 ańqıt		
ańqıtıw	V-TV-CAUS	 ańqıt		
ańqıw	V-iv	 ańqı		
ańla	V-tv	 ańla		
ańlamawshılıq	N1	 ańlamawshılıq		
ańlat	V-TV-CAUS	 ańlat		
ańlatpa	N1	 ańlatpa		
ańlaw	V-TV	 ańla		
ańlawsızdan	adv	 ańlawsızdan		
ańlı	a2	 ańlı		
ańlı	a2	 ańlı		
ańlı	V-tv	 ańlı		
ańlılıq	N1	 ańlılıq		
ańlıs	V-TV-COOP	 ańlıs		
ańlıt	V-TV-CAUS	 ańlıt		
ańlıw	V-tv	 ańlı		
ańlıwshı	N1	 ańlıwshı		
ańra	V-iv	 ańra		
ańray	V-iv	 ańray		
ańrayt	V-TV-CAUS	 ańrayt		
ańraytıw	V-TV-CAUS	 ańrayt		
ańrayıw	V-iv	 ańray		
ańrap jat	V-iv	 ańrap jat		
ańsa	V-iv	 ańsa		
ańsat	a1	 ańsat		
ańsatla	V-tv	 ańsatla		
ańsatlat	V-TV-CAUS	 ańsatlat		
ańsatlatıw	V-TV-CAUS	 ańsatlat		
ańsatlaw	V-TV	 ańsatla		
ańsatlıq	N1	 ańsatlıq		
ańsatsın	V-tv	 ańsatsın		
ańsaw	V-iv	 ańsaw		
ańsız	a1	 ańsız		
ańsızlıq	N1	 ańsızlıq		
ań-tań	a1	 ań-tań		
ańshı	N1	 ańshı		
ańshıl	a2	 ańshıl		
ańshılıq	N1	 ańshılıq		
ańız	N1	 ańız		
ańız	N1	 ańız		
apa	N1	 apa		
apay	N1	 apay		
Apaq-shapaq bol	V-iv	 Apaq-shapaq bol		
apatit	N1	 apatit		
apatlı	a2	 apatlı		
apattay	a2	 apattay		
ap-awır	a2-sup	 ap-awır		
apellatsiya	N1	 apellatsiya		
apellatsiyalıq	a2	 apellatsiyalıq		
apelsin	N1	 apelsin		
appaq	a2-sup	 appaq		
apparat	N1	 apparat		
appenditsit	N1	 appenditsit		
aprel	N1	 aprel		
aptap	N1	 aptap		
apteka	N1	 apteka		
aptechka	N1	 aptechka		
apuw	n1-vn	 apuw		
apuw et	V-tv	apuw et		
apuwayı	a2	 apuwayı		
apıl-tapıl	adv	 apıl-tapıl		
ar	N1	 ar		
ara	N1	 ara		
arab	N1-NAT	 arab		
araz	N1	 araz		
arazlan	V-iv	 arazlan		
arazlas	V-TV-COOP	 arazlas		
arazlastır	V-TV-CAUS	 arazlastır		
araslastırıw	V-TV-CAUS	 araslastır		
arazlasıw	V-iv	 arazlas		
arazlıq	N1	 arazlıq		
araq	N1	 araq		
araqxor	N1	 araqxor		
araqxorlıq	N1	 araqxorlıq		
arala	V-iv	 arala		
arala	V-tv	 arala		
aralas	a2	 aralas		
aralas	V-tv-coop	 aralas		
aralas	V-iv	 aralas		
aralasqan	V-iv	 aralas		
aralaspa	n1	 aralaspa		
aralastır	V-TV-CAUS	 aralastır		
aralastırıw	V-TV-CAUS	 aralastır		
aralasıw	V-iv	 aralas		
aralat	V-TV-CAUS	 aralat		
aralattır	V-TV-CAUS	 aralattır		
aralatıw	V-TV-CAUS	 aralat		
aralaw	V-TV	 arala		
aralıq	N1	 aralıq		
aran	N1	 aran		
arapsha	a1-nat	 arapsha		
arapshala	V-iv	 arapshala		
arapshalat	V-TV-CAUS	 arapshalat		
arasında	N1	 ara		
arasha	N1	 arasha		
arashala	V-tv	 arashala		
arashalat	V-TV-CAUS	 arashalat		
arashalaw	V-TV-CAUS	 arashala		
arashashı	N1	 arashashı		
arba	N1	 arba		
arba	V-tv	 arba		
arbay	V-iv	 arbay		
arbayt	V-TV-CAUS	 arbayt		
arbaytıw	V-TV-CAUS	 arbaytıw		
arbayıw	V-iv	 arbay		
arbakesh	N1	 arbakesh		
arbakeshlik	N1	 arbakeshlik		
arba-sarba	N1	 arba-sarba		
arbaw	V-tv	 arba		
arbawshı	N1	 arbawshı		
arbashı	N1	 arbashı		
arbitraj	N1	 arbitraj		
argument	N1	 argument		
arǵı	a2	 arǵı		
arǵımaq	N1	 arǵımaq		
ardaq	N1	 ardaq		
ardaqla	V-tv	 ardaqla		
ardaqlan	V-tv	 ardaqla		
ardaqlaw	V-TV	 ardaqla		
ardaqlı	a2	 ardaqlı		
arena	N1	 arena		
arenda	N1	 arenda		
arjaq	N1	 arjaq		
arjaqlı	a2	 arjaqlı		
arza	N1	 arza		
arzan	a1	 arzan		
arzanla	V-iv	 arzanla		
aranlat	V-TV-CAUS	 aranlat		
arzanlattır	V-TV-CAUS	 arzanlattır		
arzanlatıw	V-TV-CAUS	 arzanlat		
arzanlaw	V-iv	 arzanla		
arzı hal	N1	arzı hal		
aristokrat	N1	 aristokrat		
aristokratlıq	a2	 aristokratlıq		
aristokratiya	N1	 aristokratiya		
arifmetika	N1	 arifmetika		
arifmetikalıq	a2	 arifmetikalıq		
arifmometr	N1	 arifmometr		
ariya	N1	 ariya		
arqa	N1	 arqa		
arqa-batıs	N1	 arqa-batıs		
arqayın	a2	 arqayın		
arqayınlıq	N1	 arqayınlıq		
arqala	V-tv	 arqala		
arqalas	V-tv-coop	 arqalas		
arqalat	V-TV-CAUS	 arqalat		
arqalatıw	V-TV-CAUS	 arqalat		
arqalaw	V-TV	 arqala		
arqalı	post	 arqalı		
arqalıq	N1	 arqalıq		
arqan	N1	 arqan		
arqanla	V-tv	 arqanla		
arqanlan	V-IV-REFL	 arqanlan		
arqanlat	V-TV-CAUS	 arqanlat		
arqanlatıw	V-TV-CAUS	 arqanlat		
arqanlaw	V-TV	 arqanla		
arqanshı	N1	 arqanshı		
arqar	N1	 arqar		
arqaw	N1	 arqaw		
arqawlıq	N1	 arqawlıq		
arqash	N1	 arqash		
arqa-shıǵıs	N1	 arqa-shıǵıs		
arqılı	post	 arqılı		
arqıra	V-iv	 arqıra		
arqırat	V-TV-CAUS	 arqırat		
arqıraw	V-iv	 arqıraw		
arlan	V-iv	 arlan		
arlant	V-TV-CAUS	 arlant		
arlanıs	V-IV-COOP	 arlanıs		
arlanıw	V-iv	 arlanıw		
arlı	a2	 arlı		
arlılıq	N1	 arlılıq		
armaǵan	adv	 armaǵan		
armaǵan-bermaǵan	adv	 armaǵan-bermaǵan		
arman	adv	 arman		
arman	Post-abl	arman		
arman-berman	adv	 arman-berman		
armiya	N1	 armiya		
armyan	n1-nat	 armyan		
arna	N1	 arna		
arna	V-tv	 arna		
arnal	V-tv	 arna		
ar-namıs	N1	 ar-namıs		
ar-namıslı	a2	 ar-namıslı		
arnap	adv	 arnap		
arnat	V-TV-CAUS	 arnat		
arnatıw	V-TV-CAUS	 arnat		
arnaw	V-tv	 arnaw		
arpa	N1	 arpa		
arpalıq	N1	 arpalıq		
arpalıs	N1	 arpalıs		
arpalıs	V-iv	 arpalıs		
arpalıstır	V-TV-CAUS	 arpalıstır		
arpalısıw	V-iv	 arpalıs		
arsar	a2	 arsar		
ars-ars	ideo	 ars-ars		
arsarı	a2	 arsarı		
arsarılıq	N1	 arsarılıq		
arsız	a1	 arsız		
arsızlan	V-iv	 arsızlan		
arsızlanıw	V-iv	 arsızlan		
arsızlıq	N1	 arsızlıq		
arsılda	V-iv	 arsılda		
arsıldat	V-TV-CAUS	 arsıldat		
arsıldaw	V-iv	 arsılda		
arsın	V-iv	 arsın		
arsınıw	V-iv	 arsın		
arsınıwshı	V-iv	 arsın		
arsınıwshılıq	n1	 arsınıwshılıq		
art	N1	 art		
art	V-iv	 art		
art	V-tv	 art		
artızian	a2	 artızian		
artel	N1	 artel		
artelles	V-iv	 artelles		
artellesiw	V-iv	 artelles		
artellestir	V-TV-CAUS	 artellestir		
artellestiril	V-TV-CAUS	 artellestir		
artellestiriw	V-TV-CAUS	 artellestir		
artelshi	N1	 artelshi		
artillerist	N1	 artillerist		
artilleriya	N1	 artilleriya		
artilleriyashı	N1	 artilleriyashı		
artist	N1	 artist		
artqa	N1	 art		
artqı	a2	 artqı		
artpaq	N1	 artpaq		
arttır	V-TV-CAUS	 arttır		
arttırıl	V-TV-CAUS	 arttır		
arttırılıw	V-TV-CAUS	 arttır		
arttırıw	V-TV-CAUS	 arttır		
artıq	a2	 artıq		
artıqlıq	N1	 artıqlıq		
artıqmash	a2	 artıqmash		
artıqmashılıq	N1	 artıqmashılıq		
artıqsha	adv	 artıqsha		
artıqshılıq	N1	 artıqshılıq		
artıl	V-tv	 art		
artılıw	V-tv	 artıl		
artıs	V-TV-CAUS	 artıs		
artısıw	V-TV-CAUS	 artıs		
artıw	V-iv	 art		
aruw	a2	 aruw		
arwana	N1	 arwana		
arxaizm	N1	 arxaizm		
arxeolog	N1	 arxeolog		
arxeologiya	N1	 arxeologiya		
arxeologiyalıq	a2	 arxeologiyalıq		
arxivshi	N1	 arxivshi		
arxitektor	N1	 arxitektor		
arxitektura	N1	 arxitektura		
arxitekturalıq	a2	 arxitekturalıq		
arsha	N1	 arsha		
arsha	N1	 arsha		
arshı	V-tv	 arshı		
arshıl	V-tv	 arshı		
arshıl	N1	 arshıl		
arshıllıq	N1	 arshıllıq		
arshın	N1	 arshın		
arshınla	V-tv	 arshınla		
arshınlat	V-TV-CAUS	 arshınlat		
arshınlatıw	V-TV-CAUS	 arshınlat		
arshınlaw	V-TV	 arshınla		
arshıs	V-TV-COOP	 arshıs		
arshıt	V-TV-CAUS	 arshıt		
arshıw	V-tv	 arshı		
arı	adv	 arı		
arı	V-iv	 arı		
arı-beri	adv	 arı-beri		
arız	N1	 arız		
arızlas	V-iv	 arızlas		
arızlastır	V-TV-CAUS	 arızlastır		
arızlastırıw	V-TV-CAUS	 arızlastır		
arızlasıw	V-iv	 arızlas		
arıq	N1	 arıq		
arıq	a2	 arıq		
arıqla	V-iv	 arıqla		
arıqlat	V-TV-CAUS	 arıqlat		
arıqlaw	V-iv	 arıqla		
arıqlıq	N1	 arıqlıq		
arıqsın	V-iv	 arıqsın		
arıqsınt	V-TV-CAUS	 arıqsınt		
arıqsıntıw	V-TV-CAUS	 arıqsınt		
arıqsınıw	V-iv	 arıqsın		
arıl	V-iv	 arıl		
arılt	V-TV-CAUS	 arılt		
arıltıw	V-TV-CAUS	 arılt		
arın	V-iv	 arın		
arıs	N1	 arıs		
arıslan	V-IV-REFL	 arıslan		
arıt	V-tv-CAUS	 arıt		
arıt	V-TV-CAUS	 arıt		
arıtıw	V-tv-CAUS	 arıt		
arıtıw	V-TV-CAUS	 arıt		
as	n1	 as		
as	V-iv	 as		
as	V-tv	 as		
asa	N1	 asa		
asa	adv	 asa		
asa	V-tv	 asa		
asam	N1	 asam		
asat	V-TV-CAUS	 asat		
asatqısh	a2	 asatqısh		
asattır	V-TV-CAUS	 asattır		
asatıw	V-TV-CAUS	 asat		
asaw	a2	 asaw		
asaw	V-tv	 asa		
asawlan	V-iv	 asawlan		
asawlıq	N1	 asawlıq		
asqazan	N1	 asqazan		
asqar	N1	 asqar		
asqar	a1	asqar		
asqatıq	N1	 asqatıq		
asqatıqla	N1	 asqatıqla		
asqın	V-iv	 asqın		
asqındır	V-TV-CAUS	 asqındır		
asqınla	V-iv	 asqınla		
asqınıw	V-iv	 asqın		
asqınıwshulıq	N1	 asqınıwshulıq		
asla	adv	 asla		
aslam	post	 aslam		
aslaw	n1	 aslaw		
asman	N1	 asman		
aspa	a2	 aspa		
aspaz	N1	 aspaz		
aspazlıq	N1	 aspazlıq		
aspazshı	N1	 aspazshı		
aspalı	a2	 aspalı		
aspalı	a2	 aspalı		
aspan	N1	 aspan		
aspanıy-zámin	N1	 aspanıy-zámin		
aspanla	V-iv	 aspanla		
aspanlat	V-TV-CAUS	 aspanlat		
aspanlatıw	V-TV-CAUS	 aspanlat		
aspanlaw	V-iv	 aspanla		
aspanlıq	a2	 aspanlıq		
aspekt	N1	 aspekt		
aspirant	N1	 aspirant		
aspirantura	N1	 aspirantura		
assalawma	ij→ij	 assalawma		
assalawma áleykum	ij	 assalawma áleykum		
assambleya	N1	 assambleya		
assimilyatsiya	N1	 assimilyatsiya		
assimilyatsiyala	V-tv	 assimilyatsiyala		
assimilyatsiyalaw	V-TV	 assimilyatsiyala		
assistent	N1	 assistent		
assortiment	N1	 assortiment		
assosiatsiya	N1	 assosiatsiya		
ast	N1	 ast		
astaqta	N1	 astaqta		
astaqırın	adv	 astaqırın		
astapıralla	ij	 astapıralla		
astar	N1	 astar		
astarla	V-tv	 astarla		
astarlat	V-TV-CAUS	 astarlat		
astarlatıw	V-TV-CAUS	 astarlat		
astarlaw	V-TV	 astarla		
astarlı	a2	 astarlı		
astarlıq	N1	 astarlıq		
astronom	N1	 astronom		
astronomiya	N1	 astronomiya		
astır	V-TV-CAUS	 astır		
astır	V-TV-CAUS	 astır		
astırt	V-TV-CAUS	 astırt		
astırt	V-TV-CAUS	 astırt		
astırtın	adv	 astırtın		
asfalt	N1	 asfalt		
asfaltla	V-tv	 asfaltla		
asfaltlaw	V-TV	 asfaltla		
asfaltlı	N1	 asfaltlı		
asxana	N1	 asxana		
asxanashı	N1	 asxanashı		
asıǵıs	N1	 asıǵıs		
asıǵıs	a1	 asıǵıs		
asıǵısla	V-iv	 asıǵısla		
asıǵıslı	a2	 asıǵıslı		
asıǵıslıq	N1	 asıǵıslıq		
asıǵıw	V-iv	 asıq		
asıq	V-iv	 asıq		
asıq	N1	 asıq		
asıqlı	a2	 asıqlı		
asıqpa	V-iv	 asıq		
asıqtır	V-TV-CAUS	 asıqtır		
asıqtırt	V-TV-CAUS	 asıqtırt		
asıqtırıw	V-tv	 asıqtır		
asıl	V-tv	 as		
asılma	a2	 asılma		
asılt	V-TV-CAUS	 asılt		
asıltıw	V-TV-CAUS	 asılt		
asılıs	V-TV-COOP	 asılıs		
asılıspa	N1	 asılıspa		
asılıw	V-iv	 asıl		
asın	V-IV-REFL	 asın		
asınt	V-TV-CAUS	 asınt		
asır	V-tv	 asır		
asıra	V-tv	 asıra		
asıral	V-tv	 asıra		
asırandı	a2	 asırandı		
asırat	V-TV-CAUS	 asırat		
asıraw	V-tv	 asıra		
asırǵanlıq	N1	 asırǵanlıq		
asırt	V-TV-CAUS	 asırt		
asırıl	V-tv	 asır		
asırılıw	V-tv	 asır		
asırıw	V-tv	 asır		
asıs	V-IV-COOP	 asıs		
asıs	V-TV-COOP	 asıs		
asıw	V-iv	 as		
asıw	V-tv	 as		
at	N1	 at		
at	N1	 at		
at	V-tv	 at		
ata	N1	 ata		
ata	V-tv	 ata		
ata-ana	N1	 ata-ana		
Ata-baba	n1	Ata-baba		
shın atayı	a2	 shın atayı		
ataka	N1	 ataka		
atakala	V-tv	 atakala		
atakalaw	V-TV	 atakala		
ataq	N1	 ataq		
ataqlı	a2	 ataqlı		
ataqsız	a1	 ataqsız		
atal	V-tv	 ata		
atala	V-tv	 atala		
atalas	n1	 atalas		
atalı	a2	 atalı		
atalıq	N1	 atalıq		
atalıw	V-tv	 atal		
ataman	N1	 ataman		
atan	V-tv	 ata		
atarǵa	N1	 atarǵa		
atas	V-TV-COOP	 atas		
atastır	V-TV-CAUS	 atastır		
atastırıl	V-TV-CAUS	 atastır		
atastırıw	V-TV-CAUS	 atastır		
atasız	a2	 atasız		
atasıw	V-TV-COOP	 atas		
ataw	N1	 ataw		
ataw	V-tv	 ata		
atawız	N1	 atawız		
atawısh	a2	 atawısh		
ateizm	N1	 ateizm		
ateist	N1	 ateist		
ateistlik	a2	 ateistlik		
atelye	N1	 atelye		
atkom	N1	 atkom		
atqar	V-tv	 atqar		
atqarıl	V-tv	 atqar		
atqarıs	V-TV-COOP	 atqarıs		
atqarıw	V-tv	 atqar		
atqarıwshı	V-tv	 atqar		
atqulaq	N1	 atqulaq		
atqıla	V-tv	 atqıla		
atqılat	V-TV-CAUS	 atqılat		
atqılatıw	V-TV-CAUS	 atqılat		
atqısh	N1	 atqısh		
atla	V-tv	 atla		
atlam	N1	 atlam		
atlan	V-iv	 atlan		
atlandır	V-TV-CAUS	 atlandır		
atlanıs	N1	 atlanıs		
atlas	n1	 atlas		
atlas	n1	 atlas		
atlas	n1	 atlas		
atlas	V-IV-COOP	 atlas		
atlat	V-TV-CAUS	 atlat		
atlattır	V-TV-CAUS	 atlattır		
atlatıw	V-TV-CAUS	 atlat		
atlaw	n1	 atla		
atlaw	V-iv	 atla		
atlet	N1	 atlet		
atletika	N1	 atletika		
atletikalıq	a2	 atletikalıq		
atlı	N1	 atlı		
atlı	a2	 atlı		
atlıǵıw	V-iv	 atlıq		
atlı-jayawlı	n1	 atlı-jayawlı		
atlıq	N1	 atlıq		
atlıq	V-iv	 atlıq		
at-mat	N1	 at-mat		
atmosfera	N1	 atmosfera		
atmosferalıq	a2	 atmosferalıq		
atom	N1	 atom		
atpa-at	adv	 atpa-at		
atpala	V-iv-rep	 atpala		
atsız	a1	 atsız		
atsız	a1	 atsız		
atsızlıq	N1	 atsızlıq		
atsızlıq	N1	 atsızlıq		
attestat	N1	 attestat		
attestatsiya	N1	 attestatsiya		
attestatsiyala	V-tv	 attestatsiyala		
attır	V-TV-CAUS	 attır		
attırıw	V-TV-CAUS	 attır		
atxana	N1	 atxana		
atshoqay	N1	 atshoqay		
atız	N1	 atız		
atızla	V-tv	 atızla		
atızlıq	N1	 atızlıq		
atıl	V-IV-REFL	 atıl		
atılıw	V-iv-refl	 atıl		
atım	N1	 atım		
atıs	N1	 atıs		
atıs	V-IV-COOP	 atıs		
atıstır	V-TV-CAUS	 atıstır		
atısıw	V-IV-COOP	 atıs		
atıw	V-tv	 at		
aw	N1	 aw		
aw	ij	 aw		
aw	V-iv	 aw		
awa	ij	 awa		
awaz	N1	 awaz		
awaza	N1	 awaza		
awan	N1	 awan		
awǵan	n1-nat	 awǵan		
awdańla	V-iv	 awdańla		
awdańlaǵısh	a2	 awdańlaǵısh		
awdańlaw	V-iv	 awdańla		
awdar	V-TV-CAUS	 awdar		
awdarma	a2	 awdarma		
awdart	V-TV-CAUS	 awdart		
awdarıl	V-TV-CAUS	 awdar		
awarıs	N1	 awarıs		
awdarıs	V-TV-COOP	 awdarıs		
awdarıspaq	N1	 awdarıspaq		
awdarısıw	V-TV-COOP	 awdarıs		
awdarıw	V-TV-CAUS	 awdar		
awditoriya	N1	 awditoriya		
awdır	V-TV-CAUS	 awdır		
awdırıw	V-TV-CAUS	 awdır		
awqam	N1	 awqam		
awqamlıq	a2	 awqamlıq		
awqat	N1	 awqat		
awqatlan	V-iv	 awqatlan		
awqatlanıs	V-IV-COOP	 awqatlanıs		
awqatlanısıw	V-IV-COOP	 awqatlanıs		
awqatlanıw	V-iv	 awqatlan		
awqatlı	a2	 awqatlı		
awqatlılıq	N1	 awqatlılıq		
awla	V-tv	 awla		
awlaq	a2	 awlaq		
awlaqla	V-tv	 awlaqla		
awlaqlan	V-tv	 awlaqla		
awlaqlat	V-TV-CAUS	 awlaqlat		
awlaqlatıw	V-TV-CAUS	 awlaqlat		
awlaqlaw	V-TV	 awlaqla		
awlaqshılıq	N1	 awlaqshılıq		
awlas	V-TV-COOP	 awlas		
awlat	V-TV-CAUS	 awlat		
awlattır	V-TV-CAUS	 awlattır		
awlatıw	V-TV-CAUS	 awlat		
awlaw	V-TV	 awla		
awlıq	a2	 awlıq		
awma	a2	 awma		
awmaqay	a2	 awmaqay		
awmaqaylıq	N1	 awmaqaylıq		
awmas	a2	 awmas		
awmas	V-tv	 awmas		
awmastan	adv	 awmastan		
awmastır	V-TV-CAUS	 awmastır		
awmastırıw	V-TV-CAUS	 awmastır		
awmasıq	N1	 awmasıq		
awmasıw	V-tv	 awmas		
awna	V-iv	 awna		
awnaq	N1	 awnaq		
awnat	V-TV-CAUS	 awnat		
awnatqız	V-TV-CAUS	 awnatqız		
awnaw	V-iv	 awna		
awruw	N1	 awruw		
awruwlı	a2	 awruwlı		
awruwxana	N1	 awruwxana		
awruwshılıq	N1	 awruwshılıq		
awsıl	N1	 awsıl		
awhal	N1	 awhal		
awshı	N1	 awshı		
awshılıq	N1	 awshılıq		
awız	N1	 awız		
awızba-awız	adv	 awızba-awız		
awızǵı	a2	 awızǵı		
awızdan-awızǵa	adv	 awızdan-awızǵa		
awızeki	adv	 awızeki		
awızlan	V-iv	 awızlan		
awızlandır	V-TV-CAUS	 awızlandır		
awızlandırıw	V-TV-CAUS	 awızlandır		
awızlanıw	V-tv	 awızlan		
awızlı	a2	 awızlı		
awızlıq	N1	 awızlıq		
awızlıqla	V-tv	 awızlıqla		
awızlıqlat	V-TV-CAUS	 awızlıqlat		
awısha	adv	 awısha		
awıq	a2	 awıq		
awıl	N1	 awıl		
awıljı	V-iv	 awıljı		
awıljıw	V-iv	 awıljı		
awıl-qıslaw	n1	awıl-qıslaw		
awılla	V-iv	 awılla		
awıllas	n1	 awıllas		
awıllaslıq	n1	 awıllaslıq		
awıllat	V-TV-CAUS	 awıllat		
awıllıq	a2	 awıllıq		
awıńqıra	V-iv	 awıńqıra		
awır	a1	 awır		
awır	V-iv	 awır		
awırǵan	V-iv	 awır		
awırla	V-iv	 awırla		
awırlan	V-IV-REFL	 awırlan		
awırlat	V-TV-CAUS	 awırlat		
awırlattır	V-TV-CAUS	 awırlattır		
awırlatıw	V-TV-CAUS	 awırlat		
awırlaw	V-iv	 awırla		
awırlıq	N1	 awırlıq		
awırlıqsız	a1	 awırlıqsız		
awırsın	V-iv	 awırsın		
awırsınıw	V-iv	 awırsınıw		
awırt	V-TV-CAUS	 awırt		
awırtpaytuǵın	V-TV-CAUS	 awırt		
awırtıw	V-TV-CAUS	 awırt		
awırıq	N1	 awırıq		
awıs	a2	 awıs		
awıs	V-IV-COOP	 awıs		
awısıq	a2	 awısıq		
awısıqlıq	N1	 awısıqlıq		
awısıw	V-IV-COOP	 awıs		
awıw	V-iv	 aw		
afǵan shek	V-iv	afǵan shek		
afǵan	N1	 afǵan		
afisha	N1	 afisha		
afrikalı	n1-nat	 afrikalı		
afrikan	n1-nat	 afrikan		
affiks	N1	 affiks		
affikslik	a2	 affikslik		
ah	ij	 ah		
ahla	V-iv	 ahla		
ash	a2	 ash		
ash	V-tv	 ash		
asha	N1	 asha		
ashar	N1	 ashar		
asharshılıq	n1	 asharshılıq		
ashqıltım	a2	 ashqıltım		
ashqısh	N1	 ashqısh		
ashlıq	N1	 ashlıq		
ash-mehter	N1	 ash-mehter		
ashna	N1	 ashna		
ashnalıq	N1	 ashnalıq		
ashtır	V-TV-CAUS	 ashtır		
ashtırıw	V-TV-CAUS	 ashtır		
ashuw	N1	 ashuw		
ashuwlan	V-iv	 ashuwlan		
ashuwlandır	V-TV-CAUS	 ashuwlandır		
ashuwlant	V-TV-CAUS	 ashuwlant		
ashuwlanıs	V-IV-COOP	 ashuwlanıs		
ashuwlanısu	V-IV-COOP	 ashuwlanıs		
ashuwlanıw	V-iv	 ashuwlan		
ashuwlı	a2	 ashuwlı		
ashuwshaq	a2	 ashuwshaq		
ashuwshaqlıq	N1	 ashuwshaqlıq		
ashuwshan	a2	 ashuwshan		
ashshı	a1	 ashshı		
ashshıla	N1	 ashshıla		
ashshılat	V-TV-CAUS	 ashshılat		
ashshılatıw	V-TV-CAUS	 ashshılat		
ashshısın	N1	 ashshısın		
ashshısınıw	N1	 ashshısınıw		
ashı	N1	 ashı		
ashıǵıw	N1	 ashıǵıw		
ashıq	N1	 ashıq		
ashıq	N1	 ashıq		
ashıq	N1	 ashıq		
ashıqlıq	N1	 ashıqlıq		
ashıqlıq	N1	 ashıqlıq		
ashıl	N1	 ashıl		
ashılıs	N1	 ashılıs		
ashılıs	N1	 ashılıs		
ashılıq	N1	 ashılıq		
ashın	N1	 ashın		
ashın	N1	 ashın		
ashıńqı	N1	 ashıńqı		
ashıńqıra	N1	 ashıńqıra		
ashıńqıra	N1	 ashıńqıra		
ashırqa	N1	 ashırqa		
ashırqaw	N1	 ashırqaw		
ashırqawshılıq	N1	 ashırqawshılıq		
ashıs	N1	 ashıs		
ashıt	N1	 ashıt		
ashıtqı	N1	 ashıtqı		
ashıtqısh	N1	 ashıtqısh		
ashıttır	N1	 ashıttır		
ashıttırıw	N1	 ashıttırıw		
ashıtıw	N1	 ashıtıw		
ashıw	N1	 ashıw		
ashıw	N1	 ashıw		
ashıwlı	N1	 ashıwlı		
aerodrom	N1	 aerodrom		
aeroport	N1	 aeroport		
aerostat	N1	 aerostat		
ayıw	N1	 ayıw		
aya	N1	 aya		
ayaǵı	N1	 ayaǵı		
ayaz	N1	 ayaz		
ayazla	N1	 ayazla		
ayazlaw	V-TV	 ayazla		
ayazlı	N1	 ayazlı		
ayaq	N1	 ayaq		
ayaqla	N1	 ayaqla		
ayaqlaspa	N1	 ayaqlaspa		
ayaqlat	V-TV-CAUS	 ayaqlat		
aqaklatıw	V-TV-CAUS	 aqaklat		
ayaqlaw	V-TV	 ayaqla		
ayaqlı	N1	 ayaqlı		
ayaqsız	N1	 ayaqsız		
ayal	N1	 ayal		
ayan	N1	 ayan		
ayan	N1	 ayan		
ayan	N1	 ayan		
ayanıw	N1	 ayanıw		
ayanısh	N1	 ayanısh		
ayanıshlı	N1	 ayanıshlı		
ayanıshlıq	N1	 ayanıshlıq		
ayań	N1	 ayań		
ayańla	N1	 ayańla		
ayańlat	V-TV-CAUS	 ayańlat		
ayańlaw	V-TV	 ayańla		
ayańlı	N1	 ayańlı		
ayas	N1	 ayas		
ayasıw	N1	 ayasıw		
ayat	N1	 ayat		
ayaw	N1	 ayaw		
ayawlı	N1	 ayawlı		
ayawsız	N1	 ayawsız		
ayawsızlıq	N1	 ayawsızlıq		
ayawshı	N1	 ayawshı		
ábden	N1	 ábden		
ábes	N1	 ábes		
ábjil	N1	 ábjil		
ábzál	N1	 ábzál		
ábiger	N1	 ábiger		
ábigerlen	N1	 ábigerlen		
ábigerlendir	N1	 ábigerlendir		
ábigerleniw	N1	 ábigerleniw		
ábigerlik	N1	 ábigerlik		
ábigershilik	N1	 ábigershilik		
áger	N1	 áger		
áǵle	N1	 áǵle		
ádebiy	N1	 ádebiy		
ádebiyat	N1	 ádebiyat		
ádebiyatshı	N1	 ádebiyatshı		
ádebiyatshıl	N1	 ádebiyatshıl		
ádeyi	N1	 ádeyi		
ádelet	N1	 ádelet		
ádep	N1	 ádep		
ádep	N1	 ádep		
ádepki	N1	 ádepki		
ádeplen	N1	 ádeplen		
ádeplı	N1	 ádeplı		
ádeplilik	N1	 ádeplilik		
ádepsiz	N1	 ádepsiz		
ádepsizlik	N1	 ádepsizlik		
ádet	N1	 ádet		
ádetlen	N1	 ádetlen		
ádetlenbegen	N1	 ádetlenbegen		
ádetlendir	N1	 ádetlendir		
ádetlendiriw	N1	 ádetlendiriw		
ádetleniw	N1	 ádetleniw		
ádettegi	N1	 ádettegi		
ádewir	N1	 ádewir		
ádiyne	N1	 ádiyne		
ádil	N1	 ádil		
ádillik	N1	 ádillik		
ádilsiz	N1	 ádilsiz		
ádilsizlik	N1	 ádilsizlik		
ádip	N1	 ádip		
ádiple	N1	 ádiple		
ádiplet	N1	 ádiplet		
ádiplew	N1	 ádiplew		
ádira	N1	 ádira		
ádiraspan	N1	 ádiraspan		
ádiris	N1	 ádiris		
ádis	N1	 ádis		
ádúwle	N1	 ádúwle		
ádúwlew	N1	 ádúwlew		
ádúwli	A2	 ádúwli		
ájel	N1	 ájel		
ájelli	A2	 ájelli		
ájelsiz	N1	 ájelsiz		
ájep	N1	 ájep		
ájep	N1	 ájep		
ájeplen	N1	 ájeplen		
ájeplenerlik	N1	 ájeplenerlik		
ájepleniw	N1	 ájepleniw		
ájep-táwir	N1	 ájep-táwir		
ájiz	N1	 ájiz		
ájizle	N1	 ájizle		
ájizlen	N1	 ájizlen		
ájizlet	N1	 ájizlet		
ájizlew	N1	 ájizlew		
ájizlik	N1	 ájizlik		
ájim	N1	 ájim		
ájimli	A2	 ájimli		
ájineli	A2	 ájineli		
ájwa	N1	 ájwa		
ájwala	N1	 ájwala		
ájwalaw	V-TV	 ájwala		
ázbiray	N1	 ázbiray		
ázezil	N1	 ázezil		
ázel	N1	 ázel		
ázelgi	N1	 ázelgi		
ázelden	N1	 ázelden		
áziz	N1	 áziz		
ázil	N1	 ázil		
ázirbayjan	N1	 ázirbayjan		
áyemgi	N1	 áyemgi		
áyyemgi	N1	 áyyemgi		
áynek	N1	 áynek		
áytewir	N1	 áytewir		
áke	N1	 áke		
ákel	N1	 ákel		
ákelik	N1	 ákelik		
ákeliw	N1	 ákeliw		
áket	N1	 áket		
áketiw	N1	 áketiw		
áke-sheshe	N1	 áke-sheshe		
álbette	N1	 álbette		
álem	N1	 álem		
álewmet	N1	 álewmet		
álewmetlik	N1	 álewmetlik		
álewmetshilik	N1	 álewmetshilik		
áligi	N1	 áligi		
álippe	N1	 álippe		
álippeli	A2	 álippeli		
álle	N1	 álle		
álpayım	N1	 álpayım		
álpayımlıq	N1	 álpayımlıq		
álpeshle	N1	 álpeshle		
álpeshlew	N1	 álpeshlew		
álpi	N1	 álpi		
áltek-táltek	N1	 áltek-táltek		
álwan	N1	 álwan		
álwan-álwan	N1	 álwan-álwan		
álxámdulla	N1	 álxámdulla		
ámeki	N1	 ámeki		
ámel	N1	 ámel		
ámeldar	N1	 ámeldar		
ámelle	N1	 ámelle		
ámelles	N1	 ámelles		
ámellestir	N1	 ámellestir		
ámellet	N1	 ámellet		
ámellew	N1	 ámellew		
ámelli	A2	 ámelli		
ámelpaz	N1	 ámelpaz		
ámelpazlıq	N1	 ámelpazlıq		
ámelsiz	N1	 ámelsiz		
ámelsizlik	N1	 ámelsizlik		
ámenger	N1	 ámenger		
ámengerlik	N1	 ámengerlik		
ámengersizlik	N1	 ámengersizlik		
ámir	N1	 ámir		
ámirul-úmera	N1	 ámirul-úmera		
ándishe	N1	 ándishe		
ánjam	N1	 ánjam		
ánjamla	N1	 ánjamla		
ánjamlas	V-TV-COOP	 ánjamlas		
ánjamlaw	V-TV	 ánjamla		
ánjır	N1	 ánjır		
áńgime	N1	 áńgime		
áńgimele	N1	 áńgimele		
áńgimeles	N1	 áńgimeles		
áńgimelesiw	N1	 áńgimelesiw		
áńgimelestir	N1	 áńgimelestir		
áńgimeli	A2	 áńgimeli		
áńgimeshi	N1	 áńgimeshi		
áńgimeshil	N1	 áńgimeshil		
áptiyek	N1	 áptiyek		
ár-ár	N1	 ár-ár		
árebek	N1	 árebek		
árebi	N1	 árebi		
árem	N1	 árem		
árep	N1	 árep		
árman	N1	 árman		
ármanlan	V-IV-REFL	 ármanlan		
ármanlan	V-IV-REFL	 ármanlan		
ármanlı	N1	 ármanlı		
ármansız	N1	 ármansız		
árwaq	N1	 árwaq		
árwaqlı	N1	 árwaqlı		
ásbap	N1	 ásbap		
áser	N1	 áser		
áserli	A2	 áserli		
áset	N1	 áset		
ásir	N1	 ásir		
ásirese	N1	 ásirese		
ásirlik	N1	 ásirlik		
ásker	N1	 ásker		
áserkiy	N1	 áserkiy		
áskerlik	N1	 áskerlik		
áspek	N1	 áspek		
áste	N1	 áste		
ásteaqırın	N1	 ásteaqırın		
ástelik	N1	 ástelik		
ástenlik	N1	 ástenlik		
áteshkir	N1	 áteshkir		
áteshten	N1	 áteshten		
átkónshek	N1	 átkónshek		
s”trap	N1	 s”trap		
átraptaǵı	N1	 átraptaǵı		
áttegenay	N1	 áttegenay		
áttegene	N1	 áttegene		
átteń	N1	 átteń		
áwdiygen	N1	 áwdiygen		
awel	N1	 awel		
awelgi	N1	 awelgi		
áwelemen-dúwelemen	N1	 áwelemen-dúwelemen		
áweli	A2	 áweli		
áwere	N1	 áwere		
áwerele	N1	 áwerele		
áwerelen	N1	 áwerelen		
áwereleniw	N1	 áwereleniw		
áwerelew	N1	 áwerelew		
áwereshilik	N1	 áwereshilik		
áwesek	N1	 áwesek		
áwlad	N1	 áwlad		
áwliye	N1	 áwliye		
áwliyelik	N1	 áwliyelik		
áwliyeshilik	N1	 áwliyeshilik		
áwpilde	N1	 áwpilde		
áwsát	N1	 áwsát		
áhá	N1	 áhá		
áhmiyet	N1	 áhmiyet		
áhmiyetli	A2	 áhmiyetli		
áhmiyetlilik	N1	 áhmiyetlilik		
áhmiyetsiz	N1	 áhmiyetsiz		
áshekey	N1	 áshekey		
áshekeyli	A2	 áshekeyli		
áshkara	N1	 áshkara		
áshkarala	N1	 áshkarala		
áshkaralan	V-IV-REFL	 áshkaralan		
áshkaralw	N1	 áshkaralw		
áshkaralawlı	N1	 áshkaralawlı		
áshkaralawshı	N1	 áshkaralawshı		
ba	N1	 ba		
baba	N1	 baba		
babay	N1	 babay		
babay qaq	N1	 babay qaq		
baǵ	N1	 baǵ		
baǵan	N1	 baǵan		
baǵana	N1	 baǵana		
baǵana	N1	 baǵana		
baǵanaǵı	N1	 baǵanaǵı		
baǵdar	N1	 baǵdar		
baǵdarla	N1	 baǵdarla		
baǵdarlan	V-IV-REFL	 baǵdarlan		
baǵdarlaw	V-TV	 baǵdarla		
baǵdarlawshı	N1	 baǵdarlawshı		
baǵdarsız	N1	 baǵdarsız		
baǵlan	V-IV-REFL	 baǵlan		
baǵman	N1	 baǵman		
baǵmanlıq	N1	 baǵmanlıq		
baǵmanshılıq	N1	 baǵmanshılıq		
baǵ-sharbaq	N1	 baǵ-sharbaq		
baǵshı	N1	 baǵshı		
baǵshılıq	N1	 baǵshılıq		
baǵıl	N1	 baǵıl		
baǵın	N1	 baǵın		
baǵındır	V-TV-CAUS	 baǵındır		
baǵındırıl	N1	 baǵındırıl		
baǵındırılıw	N1	 baǵındırılıw		
baǵındırıw	N1	 baǵındırıw		
baǵınıńqı	N1	 baǵınıńqı		
baǵınıslı	N1	 baǵınıslı		
baǵınıw	N1	 baǵınıw		
baǵınıshlı	N1	 baǵınıshlı		
baǵıs	N1	 baǵıs		
baǵısıw	N1	 baǵısıw		
baǵıt	N1	 baǵıt		
baǵıtsız	N1	 baǵıtsız		
baǵıtsızlıq	N1	 baǵıtsızlıq		
baǵıw	N1	 baǵıw		
baǵıwlı	N1	 baǵıwlı		
baǵıwsız	N1	 baǵıwsız		
baǵıwsızlıq	N1	 baǵıwsızlıq		
baǵıwshı	N1	 baǵıwshı		
baǵıwshılıq	N1	 baǵıwshılıq		
baǵıshla	N1	 baǵıshla		
baǵıshlan	V-IV-REFL	 baǵıshlan		
baǵıshlandır	V-TV-CAUS	 baǵıshlandır		
baǵıshlau	N1	 baǵıshlau		
badabad	N1	 badabad		
badalǵı	N1	 badalǵı		
badalǵır	N1	 badalǵır		
badam	N1	 badam		
badana	N1	 badana		
badanaday	N1	 badanaday		
badıray	N1	 badıray		
badırayt	N1	 badırayt		
badıraq	N1	 badıraq		
badıraq	N1	 badıraq		
badırań	N1	 badırań		
badıya	N1	 badıya		
baj	N1	 baj		
baja	N1	 baja		
bajalaqla	N1	 bajalaqla		
bajalańla	N1	 bajalańla		
bajalıq	N1	 bajalıq		
baj-baj	N1	 baj-baj		
bajban	N1	 bajban		
bajbanlıq	N1	 bajbanlıq		
bajılda	N1	 bajılda		
bajıldaq	N1	 bajıldaq		
bajıldas	N1	 bajıldas		
bajılısıw	N1	 bajılısıw		
bajıldat	N1	 bajıldat		
bajıldaw	N1	 bajıldaw		
bajır	N1	 bajır		
bajıray	N1	 bajıray		
bajırańla	N1	 bajırańla		
bajırańlat	V-TV-CAUS	 bajırańlat		
bajırańlatıw	V-TV-CAUS	 bajırańlat		
bajısız	N1	 bajısız		
baz	N1	 baz		
baz	N1	 baz		
baza	N1	 baza		
bazar	N1	 bazar		
bazarlas	V-TV-COOP	 bazarlas		
bazarlat	V-TV-CAUS	 bazarlat		
